1111111111
1000001C01
100C101101
1000100001
10000P1111
10000010C1
1110001001
10000E1001
10000000C1
1111111111
