111111
1P0001
100C01
110011
100101
100E01
100001
110111
111111
